{
  "tileset" : "assets/tileset/tiletest.png",
  "tileSize" : 64,
  "tile":[
    [0, 1, 1, 1, 0, 0, 0, 0, 0, 0],
    [0, 1, 0, 1, 0, 0, 0, 0, 0, 0],
    [0, 1, 0, 1, 0, 0, 0, 0, 0, 0],
    [0, 1, 0, 1, 0, 0, 0, 0, 0, 0],
    [0, 1, 0, 1, 0, 0, 0, 0, 0, 0],
    [3, 1, 2, 1, 3, 0, 0, 0, 0, 0],
    [3, 1, 2, 1, 3, 0, 0, 0, 0, 0]
  ]
}
